80
14
41 44 41 44 41 44 41 44 41 44 41 44 41 44 41 44 41 44 41 44 43 44 45 0 0 0 0 0 0 0 0 0 0 0 0 0 0 0 0 0 0 0 0 0 0 0 0 0 0 46 47 44 42 48 47 50 47 48 49 48 49 48 49 48 49 44 41 44 43 44 41 48 47 48 47 48 47 48 47 44 
43 44 49 50 49 50 49 50 49 50 49 50 49 50 49 50 49 50 49 50 49 44 45 0 0 0 0 0 0 0 0 0 0 0 0 0 0 0 0 0 0 0 0 0 0 0 0 0 0 0 0 40 45 0 0 0 0 0 0 0 0 0 0 0 0 40 43 44 49 50 45 0 0 0 0 0 0 0 0 40 
42 45 0 0 0 0 0 0 0 0 0 0 0 0 0 0 0 0 0 0 0 46 51 0 0 0 0 0 0 0 0 0 0 0 0 0 0 0 0 0 0 0 0 0 0 0 0 0 0 0 0 40 45 0 0 0 0 0 0 0 0 0 0 0 0 40 43 44 45 0 0 0 0 0 0 0 0 0 0 40 
42 45 0 0 0 0 0 0 0 0 0 0 0 0 0 0 0 0 0 0 0 0 0 0 0 0 0 0 0 0 0 0 0 0 0 0 0 0 0 0 0 0 0 0 0 0 0 0 0 0 0 40 43 60 61 0 0 0 0 0 0 0 0 0 0 40 41 44 45 0 0 0 0 0 0 0 0 0 0 40 
42 44 35 36 35 38 35 38 39 0 0 0 0 0 0 0 0 0 0 0 0 0 0 0 0 0 0 0 34 0 0 0 0 0 0 0 0 0 0 0 0 0 0 0 0 0 0 0 0 0 0 40 45 0 0 0 0 0 0 0 58 53 57 0 0 40 41 50 51 0 0 0 0 0 0 0 0 0 0 40 
42 44 45 0 0 0 0 0 0 0 0 58 59 0 0 2 0 0 60 61 0 0 0 0 0 0 0 0 46 53 56 57 0 0 0 32 33 0 0 0 0 0 0 0 0 0 0 0 0 0 0 40 45 0 0 0 58 59 0 0 0 40 45 0 0 46 45 0 0 0 34 0 0 0 0 34 38 35 36 44 
42 45 0 0 0 0 0 0 0 0 0 0 0 0 0 0 0 0 0 0 0 0 0 0 0 0 0 0 0 0 0 0 0 0 0 0 0 0 0 0 0 32 33 0 0 0 0 0 0 0 0 40 45 0 0 0 0 0 0 0 0 40 45 0 0 0 0 0 0 0 40 39 0 0 0 0 0 0 0 40 
42 45 0 0 0 0 0 0 0 0 0 0 0 0 0 60 61 0 0 0 0 52 53 56 61 0 0 0 0 0 0 0 0 0 0 0 0 0 32 33 0 0 0 0 0 0 0 0 0 0 0 40 45 0 0 0 0 0 0 58 59 42 45 0 0 0 0 0 0 0 46 44 61 0 0 0 0 0 0 40 
42 45 0 0 0 0 0 0 0 0 0 0 0 0 0 0 0 0 0 0 0 0 0 0 0 0 0 0 0 0 0 0 0 0 0 0 0 0 0 0 0 0 0 32 33 0 0 0 0 0 0 40 45 0 0 0 0 0 0 0 0 40 45 0 0 0 0 0 0 0 0 0 0 0 0 0 0 0 0 40 
44 41 38 36 38 37 38 37 38 37 38 37 38 61 0 0 0 0 0 0 0 0 0 0 0 0 0 0 0 0 0 0 0 0 0 0 0 0 0 0 0 0 0 0 0 0 0 0 0 0 0 40 45 0 0 0 0 60 61 0 0 40 45 0 0 0 34 39 0 0 0 0 0 0 60 61 0 0 0 40 
44 45 0 0 0 0 0 0 0 0 0 0 0 0 0 58 59 0 0 0 0 0 0 0 0 0 0 60 61 0 0 0 0 0 0 0 0 0 0 0 0 0 0 0 0 0 34 39 0 0 0 0 0 0 0 0 0 0 0 0 0 40 45 0 0 0 40 45 0 0 0 0 0 0 0 0 0 0 0 40 
44 45 0 0 0 0 0 34 36 39 0 0 0 0 0 0 0 0 0 0 0 0 0 0 0 0 0 0 0 0 0 0 34 0 0 0 0 0 34 39 0 0 0 34 38 36 44 45 0 0 0 0 0 0 0 0 0 0 0 58 59 41 42 39 0 0 40 43 60 61 0 0 0 0 0 0 0 58 59 42 
44 45 0 0 0 34 35 42 42 45 0 0 0 0 0 0 0 34 39 0 0 0 0 0 0 0 0 0 0 0 0 0 40 35 36 37 38 35 42 43 38 35 38 41 42 43 44 45 0 0 0 0 0 0 0 0 0 0 0 0 0 40 45 0 0 0 40 45 0 0 0 0 0 0 0 0 0 0 0 40 
44 41 36 38 35 42 43 42 44 41 38 35 36 37 36 35 36 42 45 0 0 0 0 0 0 0 0 0 0 0 0 0 40 41 42 43 44 41 42 43 44 41 42 41 42 43 44 43 38 38 37 38 36 37 38 36 37 38 36 35 36 41 42 36 38 38 44 45 0 0 0 0 52 35 36 37 38 37 37 50 
