81
14
41 44 41 44 41 44 41 44 41 44 41 44 41 44 41 44 41 44 41 44 43 44 43 44 44 45 0 0 0 0 0 0 0 0 0 0 0 0 0 0 0 0 0 0 0 0 0 0 0 0 0 0 40 41 48 49 48 49 48 49 48 49 48 49 48 49 48 49 48 49 48 49 48 49 48 49 48 49 48 49 44 
43 44 47 50 47 50 47 50 47 50 47 50 47 50 47 50 42 43 48 50 47 44 49 50 44 45 0 0 0 0 0 0 0 0 0 0 0 0 0 0 0 0 0 0 0 0 0 0 0 0 0 0 46 51 0 0 0 0 0 0 0 0 0 0 0 0 0 0 0 0 0 0 0 0 0 0 0 0 0 40 43 
42 45 0 0 0 0 0 0 0 0 0 0 0 0 0 0 40 45 0 0 0 0 0 0 44 45 0 0 0 0 0 0 0 0 0 0 0 0 0 0 0 0 0 0 0 0 0 0 0 0 0 0 0 0 0 0 0 0 0 0 0 0 0 0 0 0 0 0 0 34 39 0 0 0 0 0 0 0 34 44 41 
42 45 0 0 0 0 0 0 0 0 0 0 0 0 0 0 40 45 0 0 0 0 0 0 44 45 0 0 0 0 0 0 0 0 0 0 0 0 0 0 0 0 0 0 0 0 0 0 0 0 0 0 0 0 0 0 0 0 0 0 0 0 0 0 0 60 61 0 0 40 42 37 38 37 38 37 38 35 42 44 41 
42 43 36 35 36 39 0 0 0 0 0 34 39 0 0 0 40 45 0 0 0 0 40 43 44 45 0 0 0 0 0 0 0 0 0 0 0 0 0 0 0 0 0 0 0 0 0 0 0 0 0 0 0 0 0 0 0 0 0 0 0 0 0 0 0 0 0 0 0 46 50 47 50 47 50 47 50 47 48 44 41 
42 45 0 0 0 46 35 36 35 36 35 50 51 0 0 0 40 45 0 0 46 47 48 49 50 51 0 0 0 0 0 0 0 0 0 0 0 0 0 0 0 0 0 0 0 0 0 0 0 0 0 0 0 0 0 0 34 39 0 0 0 0 34 39 0 0 0 0 0 0 0 0 0 0 0 0 0 0 0 0 40 
42 45 0 0 0 0 0 0 0 0 0 0 0 0 0 0 40 43 0 0 0 0 0 0 0 0 0 0 0 0 0 0 0 0 0 0 0 0 0 0 0 0 0 0 0 0 0 0 0 0 0 0 0 0 0 0 46 47 48 47 48 47 50 51 0 0 0 0 0 0 0 0 0 0 0 0 0 0 0 0 40 
42 42 38 39 0 0 0 0 0 0 0 0 0 0 0 0 40 44 39 0 0 0 0 0 0 0 0 0 0 0 0 0 0 0 0 0 0 0 0 0 0 0 0 0 0 0 0 0 0 0 0 0 0 0 34 39 0 0 0 0 0 0 0 0 0 0 0 0 0 60 61 0 0 0 0 34 39 0 0 0 40 
42 45 0 0 0 0 0 0 0 0 0 0 0 0 0 0 40 43 48 61 0 0 0 0 0 0 0 0 0 0 0 0 0 34 35 38 39 0 0 0 0 0 0 0 0 0 0 0 0 0 0 0 34 39 0 0 0 0 0 0 0 0 0 0 0 60 61 0 0 0 0 0 60 61 0 46 41 38 35 38 41 
44 41 0 0 0 0 32 33 0 0 0 0 0 0 34 35 50 51 0 0 0 0 0 0 0 0 0 34 39 0 0 0 0 40 43 44 44 35 38 35 38 38 39 0 0 0 0 0 0 0 34 38 51 0 0 0 0 0 0 0 0 0 0 0 0 0 0 0 0 0 0 0 0 0 0 0 46 49 48 44 41 
44 45 0 0 0 0 0 0 0 0 0 0 0 34 51 0 0 0 0 0 58 59 0 0 0 0 0 40 41 36 37 36 37 42 43 50 49 48 47 50 47 50 51 0 0 0 0 0 0 34 45 0 0 0 0 0 0 0 0 0 0 0 58 59 0 0 0 60 61 0 0 0 0 0 0 0 0 0 0 40 41 
44 45 0 0 0 0 0 0 0 0 0 34 36 51 0 0 0 0 0 0 0 0 0 0 0 0 46 48 49 50 49 50 49 50 51 0 0 0 0 0 0 0 0 0 0 0 0 32 33 0 46 38 39 0 0 0 0 0 0 0 0 0 0 0 0 0 0 0 0 0 0 0 0 0 0 0 0 0 0 40 41 
44 45 0 0 0 0 0 0 34 39 0 0 0 0 0 34 39 0 0 0 0 0 0 34 39 0 0 0 0 0 0 0 0 0 0 0 34 39 0 0 0 0 0 0 34 39 0 0 0 0 0 40 43 36 0 0 0 0 0 34 39 0 0 0 0 0 0 0 0 0 60 61 0 0 0 0 0 0 0 40 41 
44 45 0 0 0 0 0 0 40 41 36 37 36 37 36 43 44 37 38 37 38 37 38 44 45 0 0 0 0 0 0 0 0 0 0 0 40 41 36 36 37 38 38 37 44 45 0 0 0 0 0 40 41 42 37 38 37 38 37 44 45 0 0 0 0 0 0 0 0 0 0 0 0 0 34 35 36 35 38 35 38 
